...............
.#.###.###.##.
.#.#.......#..
.#.#.#####.#.#
.#.#.#...#.#.#
.#.#.#.#.#.#.#
.#...#.#.#...#
.#####.#.###.#
.......#.....#
.###.###.###.#
.#.#.....#...#
.#.#.#####.###
.#...........#
.#.###.#####.#
.............